11111111111111111
1000000011111C111
1P0000C111100C001
10001100000000C11
11E11111111111111
11111111111111111
