11111111111110
1E00E01111C0P1
10100001C0CC01
1C110000011001
1000C11100P001
11111101111111
