11111111111111
1001P011110001
1010M001000001
101100C0011001
1000E111001001
11111111111111
