11111111111111
1001P01111P001
10100001000001
101100C0011001
1000E111001001
11111101111111
