11111111111111111
1111111111111
1000000000001
11111111111111111
