11111111111111111
1111111111111EP
1000000000001C
11111111111111111
