11111111111110
1E00101111C001
10100001C0CC01
1C110000011001
1000C11100P001
11110001011111
