11111111111111111111
10000000000000000C01
10111111111111110C01
10111110000011110C01
10111110111111110C01
101111101PCC0CCCC0C1
10111110111111110C01
10111110000011110C01
10111111111111110C01
10100000000000000C01
10111111111111110C01
10000000000000000C01
10111111111111110C01
10E11111111111111111
11111111111111111111
